8 11
########
#.....S#
#.###..#
#......#
#.#..#.#
#.######
#.###  #
##### ##
#   #  #
#   # E#
########
